11
WWWWWWWWWWW
WLWWWWWWWWW
WWWWLLLLWWW
WWWLLLLLWWW
WWWLWWWLLWW
WWLLWLWWLWW
WWLLWWWWWWW
WWWWLWWWLWW
WWLWWWLLWWW
WLLWWWWWWWW
WWWWWWWWWWW
3
4 2 8 5
3 5 4 7
5 5 7 8
